###############################
#                 ......      #
#################      .      #
#                      .      #
#      .................      #
######    #####################
#         #                   #
#         #                   #
#                             #
###############################